sample_id	BarcodeSequence	metabo
F1	CGTAACCA	nonproducer
F4	CGTAAGAA	nonproducer
F5	CGTACCCA	producer
F6	CGTAGATA	producer
1DM	CGTAGGCT	producer
2AY	CGTATTCA	nonproducer
3LZ	CGTATTTC	producer
4SZ	CGTCAAGA	producer
5WZ	CGTCACAG	producer
6WW	CGTCCAGG	nonproducer
7HC	CGTCGCAT	producer
8CC	CGTCTGAA	producer
9WP	CGTGAGAC	producer
10YZ	CGTGATAA	producer
11YD	CGTGGGAC	producer
12LI	CGTGGTCA	producer
13YT	CGTTCACG	producer
14LY	CGTTTACT	producer
15YL	CGTTTCTA	producer
16CYX	CTAACACA	producer
17MNA	CTAACAGC	producer
